this is file 6
WWWWWWWWWWWWWWWWWWW
W.................FW
W.W.W.W.W.W.W.W.W.W.W
W...................W
W.W.W.W.W.W.W.W.W.W.W
W...................W
W.P.................W
WWWWWWWWWWWWWWWWWWWWW
