this is file 5
WWWWWWWWWWWWWWWWWWW
W.................FW
W.W.W.W.W.W.W.W.W.W.W
W.W.............W..W
W.W.W.W.W.W.W.W.W.W.W
W.P.W..............W
WWWWWWWWWWWWWWWWWWWWW
