this is file 10
WWWWWWWWWWWWWWWWWWW
W.....W.W.W.W.W....FW
W.W.W....W.W.W.W.W.W.W
W.W.W.W.W....W....W.W
W..W.W.W.W.W.W.W.W.W.W
W.P.................W
WWWWWWWWWWWWWWWWWWWWW
