this is file 7
WWWWWWWWWWWWWWWWWWW
W........W........FW
W.W.W.W.W.W.W.W.W.W.W
W..................W
W.W.W.W.W.W.W.W.W.W.W
W.P.................W
WWWWWWWWWWWWWWWWWWWWW
