this is file 9
WWWWWWWWWWWWWWWWWWW
W.....W............FW
W.W.W.W.W.W.W.W.W.W.W
W..W....W...........W
W.W.W.W.W.W.W.W.W.W.W
W.P................W
WWWWWWWWWWWWWWWWWWWWW
