this is file 3
WWWWWWWWWWWWWWWWWWW
W....W............FW
W.W.W.W.W.W.W.W.W.W.W
W....W............W
W.W.W.W.W.W.W.W.W.W.W
W.P.................W
WWWWWWWWWWWWWWWWWWWWW
