.....................
.....................
WWWWWWWWWWWWWWWWWWWWW
W..................FW
W.W.W.W.W.W.W.W.W.W.W
W...................W
W.W.W.W.W.W.W.W.W.W.W
W.P.................W
WWWWWWWWWWWWWWWWWWWWW
