this is file 4
WWWWWWWWWWWWWWWWWWW
W....W.............FW
W.W.W.W.W.W.W.W.W.W.W
W...................W
W.W.W.W.W.W.W.W.W.W.W
W.P.W..............W
WWWWWWWWWWWWWWWWWWWWW
